50 12
1 3 6
10 1 11
10 3 11
10 5 11
10 7 11
10 9 11
10 11 11
10 13 11
10 30 11
10 32 11
10 34 11
10 34 9
10 36 11
10 36 9
10 38 11
10 38 9
